#1 5x5
A - - - .
B - - . |
C C * | |
B - - . |
A - - - .